llllllllllllllllllllllllllllllll
l000000lllllllll00000000l000000l
l011110lllllll00011111100011W10l
l0111b0lll000001111111111111110l
l011110lll01W111011111100011110l
l011110lll011g10011B1110l0111b0l
l0Bs110lll0111100111p110l010000l
l010000lll00100000010000l0100lll
00100000lll010lll001000ll011000l
01111110l0001000l011110ll0011g0l
01111110l0111W10l01111000001110l
0111g110l0111110l0111B111111110l
01111110l0y11110001111000001110l
01111W10l01111111111g10lll0B110l
00100000l01000000011110lll00010l
l010lllll01000lll011000llll0110l
l010llll0011100ll0100llllll0100l
l010llll0g11110ll010llllll00100l
00100lll0111110l0010000lll0g110l
01110lll01111G0l0111110lll01110l
011100000111110l011K1d0lll01110l
01bB11111111110l01111B0lll00000l
000000000111110l0000000lllllllll
llllllll0000000lllllllllllllllll
